R 800 600

NO /path/to/no
SO /path/to/so
WE /path/to/we
EA /path/to/ea
UP /path/to/up

S  /path/to/s0
S1 /path/to/s1

F 100,100,100
C 0,128,200

L 0E 1W0 2S0 DD0 NNS0 EES1 SSS2 WWS3

1111111111111111111
120ED0D210001000001
1111101010101010001
100010101010101N001
101000100010001001
1111111111111111111