R 800 600

NO /path/to/no
SO /path/to/so
WE /path/to/we
EA /path/to/ea
UP /path/to/up

S  /path/to/s0
S1 /path/to/s1

F 100,100,100
C 0,128,200

L 0E 1W0 2S0 DD0 NN0 EE1 SS2 WW3

1111111111111111111
1200D00000000000001
1111100000000000001
100000000000000N01
1000000000000000001
1111111111111111111