R 7000 5000

NO ./texs/no0.xpm
SO ./texs/so0.xpm
WE ./texs/we0.xpm
EA ./texs/ea0.xpm

NO1 ./texs/no1.xpm
SO1 ./texs/so1.xpm
WE1 ./texs/we1.xpm
EA1 ./texs/ea1.xpm

S  ./texs/s0.xpm
S1 ./texs/s1.xpm

F 100,100,100
C 0,128,200

L 0E 1W0 2S0 DD0 NNS EES SSS WWS

        1111111111111111111111111
        1000000000110000000000001
        1011000001110000002000001
        1001000000000000000000001
111111111011000001110000000000001
100000000011000001110111111111111
11110111100001011100000010001
11110111111111011101010010001
11000000110101011100000010001
10002000000000001100000010001
10000000000000000001010010001
11000001110101011111011110N0111
11110111 1110101 101000000001
11111111 1111111 111111111111